######################################################################
##                                                                  ##
##                                                                  ##
###################%#############%############                      ##
##                                                                  ##
##                                                                  ##
##                                      ##                          ##
##                                ####%%########%%####################
##                #####                                             ##
##                                                                  ##
######################################################################
##                                                                  ##
##                                                                  ##
##                                                                  ##
#####%%##################################                           ##
##DDD                                                               ##
##DDD                                                               ##
##############%##############%###########%%###########################
######################################################################
