######################################################################
##                                                                  ##
##                                                                  ##
##                                                                  ##
##                                                                  ##
##                                                                  ##
##          ####                                     ####           ##
##                                                                  ##
##          ##################         ##################           ##
##                                                                  ##
##      ########          #################          ########       ##
##                                                                  ##
##           ################           ################            ##
##                                                                  ##
##                                                                  ##
##                                                                  ##
##                                                                  ##
%%%%%%%%%%%%%%%%%%%%%%%%%%%%%%%%%%%%%%%%%%%%%%%%%%%%%%%%%%%%%%%%%%%%%%
######################################################################
