######################################################################
##                                                                  ##
##                                                                  ##
##                                                                  ##
##                                                                  ##
##                                                                  ##
##                         #############                            ##
##                                                                  ##
##          ##################         ##################           ##
##                                                                  ##
##      ########                                     ########       ##
##                                                                  ##
##           ###########################################            ##
##                                                                  ##
##                                                                  ##
##                                                                  ##
##                                                                  ##
%%%%%%%%%%%%%%%%%%%%%%%%%%%%%%%%%%%%%%%%%%%%%%%%%%%%%%%%%%%%%%%%%%%%%%
######################################################################