######################################################################
##                                                                  ##
##                                                                  ##
##                                                                  ##
##                                                                  ##
##                                                                  ##
##      ####                                             ####       ##
##                                                                  ##
##      ########                                     ########       ##
##                                                                  ##
##      ##############                         ##############       ##
##                                                                  ##
##           ################    ####   ################            ##
##                                                                  ##
##                                                                  ##
##                                                                  ##
##                                                                  ##
%%%%%%%%%%%%%%%%%%%%%%%%%%%%%%%%%%%%%%%%%%%%%%%%%%%%%%%%%%%%%%%%%%%%%%
######################################################################