######################################################################
##                                                                  ##
##                                                                  ##
##                                                                  ##
##                                                                  ##
##                                                                  ##
##          ####          #################          ####           ##
##                                                                  ##
##                ######                     ######                 ##
##                                                                  ##
##      ########               #######               ########       ##
##                                                                  ##
##               #############         #############                ##
##                                                                  ##
##                                                                  ##
##                                                                  ##
##                                                                  ##
%%%%%%%%%%%%%%%%%%%%%%%%%%%%%%%%%%%%%%%%%%%%%%%%%%%%%%%%%%%%%%%%%%%%%%
######################################################################