######################################################################
##                                                                  ##
##                                                                  ##
##                                                                  ##
##                                                                  ##
##                                                                  ##
##                            #########                             ##
##                                                                  ##
##     ####           ########         ########           ####      ##
##                                                                  ##
##            ########                         ########             ##
##                                                                  ##
##           ############     #########     ############            ##
##                                                                  ##
##                                                                  ##
##                                                                  ##
##                                                                  ##
%%%%%%%%%%%%%%%%%%%%%%%%%%%%%%%%%%%%%%%%%%%%%%%%%%%%%%%%%%%%%%%%%%%%%%
######################################################################